WWWWWWWWWWWWWWW
W        P    W
W S         S W
W   W     W   W
WWWWW     WWWWW
W         W   W
W G         G W
W     PP      W
WWWWWWWWWWWWWWW
